NO ../TEXTURES/SandstoneskullsD.gif
SO ../TEXTURES/Stone1D.gif
WE ../TEXTURES/StoneUWHitlerL.gif
EA ../TEXTURES/SteelwallL.gif

F 128,128,128
C 102,51,0

1111111111111111111
1000000000000000001
1001110000100000001
1001110000100000001
1000000000111110000
1000000111100000001
1000000100100000001
11100001001000N0001
1110000000000000001
1111111111111111111