NO ../TEXTURES/SandstoneskullsD.gif
SO ../TEXTURES/Stone1D.gif
WE ../TEXTURES/StoneUWHitlerL.gif
EA ../TEXTURES/SteelwallL.gif

F 128,128,128
C 102,51,0

111111
100101
101001
1100N1
111111